NO ./textures/colorstone.xpm

SO ./textures/greystone.xpm

F       91, 43,7

WE ./textures/redbrick.xpm

EA ./textures/wood.xpm


C     0, 0, 51 

                      1111111111111111
                     110000000000000011
                    11000000000000000011    
                   1100000000000000000011
                  110000000000000000000011      
                 11000000000000000000000011
                1100000000001111000000000011
               11000000000011  11000000000011
              11000000000011    11000000000011
             11000000000011      11000000000011
            11000000000011        11000000000011
           11000000000011          11000000000011
          11000000000011            110000N0000011
         11000000000011              11000000000011
        11000000000011                11000000000011
       11000000000011                  11000000000011
      11000000000011                    11000000000011
     11000001000011                      11000000000011
    11000000000011                        11000000000011
   11000000000011                          11000000000011
  11000000000011                            11000000000011
 11000000000011                              11000000010011
11000000000011                                11000000000011
11000000000011                                11000000000011
 11000000000011                              11000000000011
  11000000000011                            11000000000011 
   11000000000011                          11000000000011
    11000000000011                        11000000000011
     11000000000011                      11000000000011
      11000000000011                    11000000000011
       11000000000011                  11000000000011
        11000000000011                11000000000011
         11000000000011              11000000000011
          11000000000011            11000000000011
           11000000000011          11000000000011
            11000000000011        11000000000011
             11000000000011      11000000000011
              11000000000011    11000000000011
               11000000000011  11000000000011
                1100000000001111000000000011
                 11000000000000000000000011
                  110000000000000000000011
                   1100000000000000000011
                    11000000000000000011
                     111111111111111111