NO ./textures/walln.xpm

SO ./textures/walls.xpm

C       68,44,12

WE ./textures/wallw.xpm

EA ./textures/walle.xpm


F     75,57,59

        
        11111111111111111111111111111111111111
        10000000000000000000000000000000000001
        10000000000000000000111000000000000001
        100000000011000000001 1000000000000001
        10110000011100000000111000000000000W01
        10010000000000000000000000000000000001
1111111110110000011100000000000000000000000001
1000000000110000011101111110111111111111111111
11110111111111011100000010001
11110111111111011101010010001
11000000110101011100000010001
10000000000000001100000010001
10000000000000001101010010001
1100000111010101111101111000111
11110111 1110101 101111010001
11111111 1111111 111111111111