NO ./textures/colorstone.xpm

SO ./textures/greystone.xpm

F       -256,-256,-256

WE ./textures/redbrick.xpm


EA ./textures/wood.xpm

C -256, -256, -256

11111111111111111
10000000000000001
1111100001000000111111
     100000000N0000001
     10000000000000001
1111100001000000111111
10000000010000001
11111111111111111
