NO ./textures/colorstone.xpm

SO ./textures/greystone.xpm

F       -256,-256,-256

WE ./textures/redbrick.xpm


EA ./textures/wood.xpm

C -256, -256, -256

        1111111111111111111111111
        1000000000110000000000001
        1011000001110000000000001
        1001000000000000000000001
111111111011000001110000000000001
100000000011000001110111111111111
11110111111111011100000010001
11110111111111011101010010001
11000000110101011100000111111
10000000000000001100000100001
10000000000000001101010100001
11000001110101011111011100N0111
11110111 1110101 101111100001
11111111 1111111 111111111111
