NO ./textures/colorstone.xpm

SO ./textures/greystone.xpm

F       0, 155,0

WE ./textures/redbrick.xpm

EA ./textures/wood.xpm

C 0, 0, 155

11111111111111111
10000000000000001
1111100001000000111111
     10000000100000001
     10000000000000001
1111100001000000111111
10000000010000001
11111110011111111
11111110011111111
10000000000000001
10000000000000001
10000000000000001
100000000000000011111111111111111
1000000000000000000000000000000001
1000000000000000000000000000000001
1000000000000000000000000000000001
1000000000000000000000000000000001
10000000000000S0000000000000000001
111110111111111111111111111111111
    101
    101
    101
    101
    101
    101
    101
    101
    101
    101
    101
    101
    101
    101
    101
    101
    101
    101
    101
    101
    111