NO ./textures/colorstone.xpm

SO ./textures/greystone.xpm

F       180, 155,150

WE ./textures/redbrick.xpm

EA ./textures/wood.xpm


C 0, 0, 350

        1111111111111111111111111
        1000000000110000000000001
        1011000001110000000000001
        1001000000000000000000001
111111111011000001110000000000001
100000000011000001110111111111111
11110111111111011100000010S01
11110111111111011101010010001
11000000110101011100000000001
10000000000000001100000010001
10000000000000001101010010001
1100000111010101111101111000111
11110111 1110101 101111010001
11111111 1111111 111111111111


11111111111111111
10000000000000001
1111100001000000111111
     10000000100000001
     10000000000000001
1111100001000000111111
10000000010000001
11111110011111111
11111110011111111
10000000000000001
10000000000000001
10000000000000001
100000000000000011111111111111111
1000000000000000000000000000000001
1000000000000000000000000000000001
1000000000000000000000000000000001
1000000000000000000000000000000001
10000000000000S0000000000000000001
111110111111111111111111111111111
    101
    101
    101
    101
    101
    101
    101
    101
    101
    101
    101
    101
    101
    101
    101
    101
    101
    101
    101
    101
    111
