NO ./textures/colorstone.xpm

SO ./textures/greystone.xpm

F       0, 255,0

WE ./textures/redbrick.xpm


EA ./textures/wood.xpm

C 0, 0, 255

11111111111111111
10000000000000001
111110N001000000111111
     10000000000000001
     10000000000000001
1111100001000000111111
10000000010000001
11111111111111111
