NO ./textures/colorstone.xpm

SO ./textures/greystone.xpm

F       91, 43,7

WE ./textures/redbrick.xpm

EA ./textures/wood.xpm


C     0, 0, 51 

        
        11111111111111111111111111111111111111
        10000000000000000000000000000000000001
        10000000000000000000111000000000000001
        100000000011000000001 1000000000000001
        10110000011100000000111000000000000W0111111111111111
        1001000000000000000000000000000000000000000000000001
111111111011000001110000000000000000000000000000000000000001
100000000011000001110111111011111111111111111111111111111111  
11110111111111011100000010001
11110111111111011101010010001
11000000110101011100000010001
10000000000000001100000010001
10000000000000001101010010001
1100000111010101111101111000111
11110111 1110101 101111010001
11111111 1111111 111111111111